Penitenciária de Coimbra
10
1347006060
1347006061
1347006063
1347006047
1347006056
1347006048
1347006072
1347006058
1347006059
1347006062
Tribunal
9
1279555600
1279555585
1279555588
1279555593
1279555599
1279555603
1279555602
1279555592
1279555600
PSP - Esquadra de Transito
6
711089932
761324442
711089935
711089938
711089939
711089932
